N;CN;1;1;1;1;C
1;P;1;2;1;N;1
C;1;CC;2;N;1;C
C;X;2;1;1;1;1
1;X;1;X;X;2;1
2;N;1;1;2;2;1
C;N;1;1;N;2;X